Jack, the Mexican that showed up a couple days ago needs the fingers on his left had to be cut off due to frostbite. He sits in a chair in the barn. You'll need a sharp knife, a hammer, a needle, thread, and clean rags to cut it off.

Daughter of Fortune
An Interactive Fiction by Izzy
Release 1 / Serial number 141007 / Inform 7 build 6L02 (I6/v6.33 lib 6/12N) SD

Barn
Joe and Babalu stand by in the barn. Jack sits in a chair by a table and stove. You can go into your room, Joe Bonecrusher's Room, the Doves" Room, and the Kitchen. You could also go outside, even though it's really cold.

>gimme gimme gimmme
I didn't understand that sentence.

>gimme gimme gimme
But why
Barn
Joe and Babalu stand by in the barn. Jack sits in a chair by a table and stove. You can go into your room, Joe Bonecrusher's Room, the Doves" Room, and the Kitchen. You could also go outside, but it's freezing and probably not a good idea.

>i
You are carrying:
  Key
  Clean rags
  Thread
  Needle
  Hammer
  Knife

* * *

Jack, the Mexican that showed up a couple days ago needs the fingers on his left had to be cut off due to frostbite. He sits in a chair in the barn. You'll need a sharp knife, a hammer, a needle, thread, and clean rags to cut it off.

Daughter of Fortune
An Interactive Fiction by Izzy
Release 1 / Serial number 141007 / Inform 7 build 6L02 (I6/v6.33 lib 6/12N) SD

Barn
Joe and Babalu stand by in the barn. Jack sits in a chair by a table and stove. You can go into your room, Joe Bonecrusher's Room, the Doves" Room, and the Kitchen. You could also go outside, even though it's really cold.

>gimme gimme gimme
But why
Barn
Joe and Babalu stand by in the barn. Jack sits in a chair by a table and stove. You can go into your room, Joe Bonecrusher's Room, the Doves" Room, and the Kitchen. You could also go outside, but it's freezing and probably not a good idea.

* * *

>i
You are carrying:
  Key
  Clean rags
  Thread
  Needle
  Hammer
  Knife

>x jack
Jack showed up outside the barn three days ago. To you, he smells of evil and you don't trust him. Now isn't the time to worry about that, his fingers need to be amputated and bandaged.

>restart
Are you sure you want to restart?

>yes
Jack, the Mexican that showed up a couple days ago needs the fingers on his left had to be cut off due to frostbite. He sits in a chair in the barn. You'll need a sharp knife, a hammer, a needle, thread, and clean rags to cut it off.

Daughter of Fortune
An Interactive Fiction by Izzy
Release 1 / Serial number 141002 / Inform 7 build 6L02 (I6/v6.33 lib 6/12N) SD

Barn
Joe and Babalu stand by in the barn. Jack sits in a chair by a table and stove. You can go into your room, Joe Bonecrusher's Room, the Doves" Room, and the Kitchen. You could also go outside, but it's freezing and probably not a good idea.

>take all
Binding cloth: Taken.
Music Sheets: Taken.
Jacket: Taken.
Needle: That seems to belong to Esther.

* * *

Jack, the Mexican that showed up a couple days ago needs the fingers on his left had to be cut off due to frostbite. He sits in a chair in the barn. You'll need a sharp knife, a hammer, a needle, thread, and clean rags to cut it off.

Daughter of Fortune
An Interactive Fiction by Izzy
Release 1 / Serial number 141007 / Inform 7 build 6L02 (I6/v6.33 lib 6/12N) SD

Barn
Joe and Babalu stand by in the barn. Jack sits in a chair by a table and stove. You can go into your room, Joe Bonecrusher's Room, the Doves" Room, and the Kitchen. You could also go outside, even though it's really cold.

>x joe
Which do you mean, Joe Bonecrusher's Room or Joe Bonecrusher?

* * *

Jack, the Mexican that showed up a couple days ago needs the fingers on his left had to be cut off due to frostbite. He sits in a chair in the barn. You'll need a sharp knife, a hammer, a needle, thread, and clean rags to cut it off.

Daughter of Fortune
An Interactive Fiction by Izzy
Release 1 / Serial number 141007 / Inform 7 build 6L02 (I6/v6.33 lib 6/12N) SD

Barn
Joe and Babalu stand by in the barn. Jack sits in a chair by a table and stove. You can go into your room, Joe Bonecrusher's Room, the Doves" Room, and the Kitchen. You could also go outside, even though it's really cold.

>ask joe about what you need
(Joe Bonecrusher about that)
You said that you needed a knife, a hammer, thread, a needle, and clean rags.I already gave it to you.

* * *

Jack, the Mexican that showed up a couple days ago needs the fingers on his left had to be cut off due to frostbite. He sits in a chair in the barn. You'll need a sharp knife, a hammer, a needle, thread, and clean rags to cut it off.

Daughter of Fortune
An Interactive Fiction by Izzy
Release 1 / Serial number 141007 / Inform 7 build 6L02 (I6/v6.33 lib 6/12N) SD

Barn
Joe and Babalu stand by in the barn. Jack sits in a chair by a table and stove. You can go into your room, Joe Bonecrusher's Room, the Doves" Room, and the Kitchen. You could also go outside, even though it's really cold.

>i
You are carrying nothing.

>ask joe about key
(Joe Bonecrusher about that)
Here, I have it.I already gave it to you.

>x joe
(Joe Dresser)
The dresser's large and made from some wood you don't recognize. You don't have the key to it and Joe probably wouldn't give it to you. There are probably other ways to get into it though.

* * *

Jack, the Mexican that showed up a couple days ago needs the fingers on his left had to be cut off due to frostbite. He sits in a chair in the barn. You'll need a sharp knife, a hammer, a needle, thread, and clean rags to cut it off.

Daughter of Fortune
An Interactive Fiction by Izzy
Release 1 / Serial number 141007 / Inform 7 build 6L02 (I6/v6.33 lib 6/12N) SD

Barn
Joe and Babalu stand by in the barn. Jack sits in a chair by a table and stove. You can go into your room, Joe Bonecrusher's Room, the Doves" Room, and the Kitchen. You could also go outside, even though it's really cold.

>take all
Find the items yourself.

* * *

Jack, the Mexican that showed up a couple days ago needs the fingers on his left had to be cut off due to frostbite. He sits in a chair in the barn. You'll need a sharp knife, a hammer, a needle, thread, and clean rags to cut it off.

Daughter of Fortune
An Interactive Fiction by Izzy
Release 1 / Serial number 141007 / Inform 7 build 6L02 (I6/v6.33 lib 6/12N) SD

Barn
Joe and Babalu stand by in the barn. Jack sits in a chair by a table and stove. You can go into your room, Joe Bonecrusher's Room, the Doves" Room, and the Kitchen. You could also go outside, even though it's really cold.

>go into eliza r
You can't get into the closed Eliza R.

>open eliza r
You open Eliza R.

>go into eliza r
You get into Eliza R.

>get out
You get out of Eliza R.

Barn
You can see Babalu the Bad, Joe Bonecrusher, Jack and Eliza R (empty) here.

* * *

Jack, the Mexican that showed up a couple days ago needs the fingers on his left had to be cut off due to frostbite. He sits in a chair in the barn. You'll need a sharp knife, a hammer, a needle, thread, and clean rags to cut it off.

Daughter of Fortune
An Interactive Fiction by Izzy
Release 1 / Serial number 141007 / Inform 7 build 6L02 (I6/v6.33 lib 6/12N) SD

Barn
Joe and Babalu stand by in the barn. Jack sits in a chair by a table and stove. You can go into your room, Joe Bonecrusher's Room, the Doves" Room, and the Kitchen. You could also go outside, even though it's really cold.

>go into joe r
You get into Joe Bonecrusher's Room.

>x joe r
All you're looking for from Joe's room is the hammer, it's probably best not to touch her bed or dresser if you don't want to get into trouble. You see a bottle of something in Joe's room.

>inspect bottle
That's not a verb I recognise.

>undo
Barn
[Previous turn undone.]

* * *

Jack, the Mexican that showed up a couple days ago needs the fingers on his left had to be cut off due to frostbite. He sits in a chair in the barn. You'll need a sharp knife, a hammer, a needle, thread, and clean rags to cut it off.

Daughter of Fortune
An Interactive Fiction by Izzy
Release 1 / Serial number 141007 / Inform 7 build 6L02 (I6/v6.33 lib 6/12N) SD

Barn
Joe and Babalu stand by in the barn. Jack sits in a chair by a table and stove. You can go into your room, Joe Bonecrusher's Room, the Doves" Room, and the Kitchen. You could also go outside, even though it's really cold.

>go into your room
You get into Your Room.

>x your room
You share this room with Babalu the Bad and Tom No-Tribe. The bed is big enough for all three of you to fit, but usually Babalu is awake at night and paces along the barn, so usually it's just you and Tom No-Tribe keeping warm. Along the barn wall is a bag with your belongings.

>talk to tom no-tribe
You must supply a second noun.

>talk to tom-no tribe about needle
You can't see any such thing.

>ask tom about needle
Tom No-Tribe says that the Dove Sisters would probably have that type of stuff. They're most likely to need it since they're girls.

>talk to tom
You must supply a second noun.

>about needle
That's not a verb I recognise.

>talk to tom about needle
I only understood you as far as wanting to talk to Tom No-Tribe.

* * *

Jack, the Mexican that showed up a couple days ago needs the fingers on his left had to be cut off due to frostbite. He sits in a chair in the barn. You'll need a sharp knife, a hammer, a needle, thread, and clean rags to cut it off.

Daughter of Fortune
An Interactive Fiction by Izzy
Release 1 / Serial number 141007 / Inform 7 build 6L02 (I6/v6.33 lib 6/12N) SD

Barn
Joe and Babalu stand by in the barn. Jack sits in a chair by a table and stove. You can go into your room, Joe Bonecrusher's Room, the Doves" Room, and the Kitchen. You could also go outside, even though it's really cold.

>go outside
Barnyard
The strong wind blows you around and you lose your bearings.

>undo
Barn
[Previous turn undone.]

>go into room
You can't see any such thing.

>go into my room
You get into Your Room.

>x my room
You share this room with Babalu the Bad and Tom No-Tribe. The bed is big enough for all three of you to fit, but usually Babalu is awake at night and paces along the barn, so usually it's just you and Tom No-Tribe keeping warm. Along the barn wall is a bag with your belongings.

>x bag
You store all your stuff in here.

In your bag are Binding cloth, Music Sheets and Jacket.

>go to barnyard
You can't see any such thing.

>exit room
I only understood you as far as wanting to exit.

>exit my room
I only understood you as far as wanting to exit.

>go to barn
You can't see any such thing.

>barn
That's not a verb I recognise.

>go to barn
You can't see any such thing.

>leave my room
I only understood you as far as wanting to leave.

>leave
You get out of Your Room.

Barn
Joe and Babalu stand by in the barn. Jack sits in a chair by a table and stove. You can go into your room, Joe Bonecrusher's Room, the Doves" Room, and the Kitchen. You could also go outside, but it's freezing and probably not a good idea.

>x joe
(Joe Dresser)
The dresser's large and made from some wood you don't recognize. You don't have the key to it and Joe probably wouldn't give it to you. There are probably other ways to get into it though.

>ask joe for key
You can't see any such thing.

>talk to joe
(Joe Bonecrusher)
Try asking Tom about something what you need instead.

>ask joe about key
(Joe Bonecrusher about that)
There is no reply.

>touch joe
(Joe Dresser)
You feel nothing unexpected.

>talk to bablu
You can't see any such thing.

>talk to babalu
Try asking Tom about something what you need instead.

>ask tom about key
Tom doesn't seem to want to talk about it and just looks away from you.

There is no reply.

>talk to jack
Try asking Tom about something what you need instead.

>break dresser
Which do you mean, Joe Dresser or Doves Dresser?

>Joe dresser
Violence isn't the answer to this one.

>doves dresser
That's not a verb I recognise.

>break doves dresser
Violence isn't the answer to this one.

>open joe dresser
It seems to be locked.

>i
You are carrying nothing.

>go into doves room
You get into The Doves" Room.

>x doves room
All the Doves share this room. The two sisters stand by their blue bed. The younger sister is facing her older sister. The Mexican Dove is sleeping on the red bed. Esther stand in the corner by a dresser.

>talk to two sisters
You can't use multiple objects with that verb.

>talk to sisters
You can't see any such thing.

>talk to young sister
You can't see any such thing.

>talk to older sister
Try asking Tom about something what you need instead.

>ask tom what i need
I didn't understand that sentence.

>take needle
That seems to belong to Esther.

>talk to esther
Try asking Tom about something what you need instead.

>ask esther for needle
Esther has better things to do.

>open dresser
Which do you mean, Joe Dresser or Doves Dresser?

>x dresser
Which do you mean, Joe Dresser or Doves Dresser?

* * *

Jack, the Mexican that showed up a couple days ago needs the fingers on his left had to be cut off due to frostbite. He sits in a chair in the barn. You'll need a sharp knife, a hammer, a needle, thread, and clean rags to cut it off.

Daughter of Fortune
An Interactive Fiction by Izzy
Release 1 / Serial number 141007 / Inform 7 build 6L02 (I6/v6.33 lib 6/12N) SD

Barn
Joe and Babalu stand by in the barn. Jack sits in a chair by a table and stove. You can go into your room, Joe Bonecrusher's Room, the Doves" Room, and the Kitchen. You could also go outside, even though it's really cold.

>go in your area
You can't see any such thing.

>open your area
You can't see any such thing.

* * *

Jack, the Mexican that showed up a couple days ago needs the fingers on his left had to be cut off due to frostbite. He sits in a chair in the barn. You'll need a sharp knife, a hammer, a needle, thread, and clean rags to cut it off.

Daughter of Fortune
An Interactive Fiction by Izzy
Release 1 / Serial number 141007 / Inform 7 build 6L02 (I6/v6.33 lib 6/12N) SD

Barn
Joe and Babalu stand by in the barn. Jack sits in a chair by a table and stove. You can go into your room, Joe Bonecrusher's Room, the Doves" Room, and the Kitchen. You could also go outside, even though it's really cold.

>go into joe's room
You get into Joe Bonecrusher's Room.

>x room
You can't see any such thing.

* * *

>go into joe's room
You get into Joe Bonecrusher's Room.

>go out
You would have to get out of Joe Bonecrusher's Room first.

>leave joe's room
I only understood you as far as wanting to leave.

>go out of joe's room
I only understood you as far as wanting to go outside.

>exit
You get out of Joe Bonecrusher's Room.

Barn
Joe and Babalu stand by in the barn. Jack sits in a chair by a table and stove. You can go into your room, Joe Bonecrusher's Room, the Doves" Room, and the Kitchen. You could also go outside, but it's freezing and probably not a good idea.

>go into joe's room
You get into Joe Bonecrusher's Room.

>out
You get out of Joe Bonecrusher's Room.

Barn
Joe and Babalu stand by in the barn. Jack sits in a chair by a table and stove. You can go into your room, Joe Bonecrusher's Room, the Doves" Room, and the Kitchen. You could also go outside, but it's freezing and probably not a good idea.

>go into dove's room
You can't see any such thing.

>go into doves' room
You get into The Doves" Room.

>x room
You can't see any such thing.

>x doves room
All the Doves share this room. The two sisters stand by their blue bed. The younger sister is facing her older sister. The Mexican Dove is sleeping on the red bed. Esther stand in the corner by a dresser.

>x esther
You see nothing special about Esther.

* * *

>go into joe's room
You get into Joe Bonecrusher's Room.

>exit
You get out of Joe Bonecrusher's Room.

Barn
Joe and Babalu stand by in the barn. Jack sits in a chair by a table and stove. You can go into your room, Joe Bonecrusher's Room, the Doves" Room, and the Kitchen. You could also go outside, but it's freezing and probably not a good idea.

* * *

Jack, the Mexican that showed up a couple days ago needs the fingers on his left had to be cut off due to frostbite. He sits in a chair in the barn. You'll need a sharp knife, a hammer, a needle, thread, and clean rags to cut it off.

Daughter of Fortune
An Interactive Fiction by Izzy
Release 1 / Serial number 141007 / Inform 7 build 6L02 (I6/v6.33 lib 6/12N) SD

Barn
Joe and Babalu stand by in the barn. Jack sits in a chair by a table and stove. You can go into your room, Joe Bonecrusher's Room, the Doves" Room, and the Kitchen. You could also go outside, even though it's really cold.

>ask joe for key
(Joe Bonecrusher for Key)
Joe Bonecrusher has better things to do.

>x joe
Which do you mean, Joe Bonecrusher's Room or Joe Bonecrusher?

>joe bonecrusher
Joe's a kind person.

>ask joe what he likes
I didn't understand that sentence.

>ask joe for key
(Joe Bonecrusher for Key)
Joe Bonecrusher has better things to do.

>ask joe about knife
(Joe Bonecrusher about that)
What'd you say, boy? Ask me something else.

There is no reply.

>ask joe about hammer
(Joe Bonecrusher about that)
That's inside of the toolbox.I already gave it to you.

>i
You are carrying:
  Key

>ask joe about needle
(Joe Bonecrusher about that)
What'd you say, boy? Ask me something else.

There is no reply.

>ask joe about thread
(Joe Bonecrusher about that)
What'd you say, boy? Ask me something else.

There is no reply.

>go to kitchen
You can't see any such thing.

>enter kitchen
You get into Kitchen.

On Counter is Big box (closed).

>oepn box with key
That's not a verb I recognise.

>open box with key
(Big box with Key)
You unlock Big box.

>big box
That's not a verb I recognise.

>x big box
The box is made of wood. Joe usually has the key to unlock it.

>open small box with key
That doesn't seem to fit the lock.

>i
You are carrying:
  Key

>take knife
You can't see any such thing.

>x big box
The box is made of wood. Joe usually has the key to unlock it.

>look inside big box
You can't see inside, since Big box is closed.

>open big box with key
That's unlocked at the moment.

>open big box
You open Big box, revealing nothing.

>leave
You get out of Kitchen.

Barn
Joe and Babalu stand by in the barn. Jack sits in a chair by a table and stove. You can go into your room, Joe Bonecrusher's Room, the Doves" Room, and the Kitchen. You could also go outside, but it's freezing and probably not a good idea.

>enter kitchen
You get into Kitchen.

On Counter is Big box.

>take knife
Taken.

>i
You are carrying:
  Knife
  Key

>leave
You get out of Kitchen.

Barn
Joe and Babalu stand by in the barn. Jack sits in a chair by a table and stove. You can go into your room, Joe Bonecrusher's Room, the Doves" Room, and the Kitchen. You could also go outside, but it's freezing and probably not a good idea.

>ask babalu about needle
You're a funny one, Elias.

There is no reply.

>ask babalu about thread
You're a funny one, Elias.

There is no reply.

>ask joe about hammer
(Joe Bonecrusher about that)
That's inside of the toolbox.I already gave it to you.

>i
You are carrying:
  Knife
  Key

>x toolbox
Usually only Joe and Babalu use the toolbox.

>take toolbox
That's hardly portable.

* * *

Jack, the Mexican that showed up a couple days ago needs the fingers on his left had to be cut off due to frostbite. He sits in a chair in the barn. You'll need a sharp knife, a hammer, a needle, thread, and clean rags to cut it off.

Daughter of Fortune
An Interactive Fiction by Izzy
Release 1 / Serial number 141007 / Inform 7 build 6L02 (I6/v6.33 lib 6/12N) SD

Barn
Joe and Babalu stand by in the barn. Jack sits in a chair by a table and stove. You can go into your room, Joe Bonecrusher's Room, the Doves" Room, and the Kitchen. You could also go outside, even though it's really cold.

>outside
Barnyard
The strong wind blows you around and you lose your bearings.

>damn it
That's not a verb I recognise.

>west
You can't go that way.

>north
You can't find your way now.

>south
Road S

    *** After losing your bearings and wandering around, you finally freeze to death. Probably should've just stayed inside silly girl. ***

Would you like to RESTART, RESTORE a saved game, QUIT or UNDO the last command?

>restart
Jack, the Mexican that showed up a couple days ago needs the fingers on his left had to be cut off due to frostbite. He sits in a chair in the barn. You'll need a sharp knife, a hammer, a needle, thread, and clean rags to cut it off.

Daughter of Fortune
An Interactive Fiction by Izzy
Release 1 / Serial number 141007 / Inform 7 build 6L02 (I6/v6.33 lib 6/12N) SD

Barn
Joe and Babalu stand by in the barn. Jack sits in a chair by a table and stove. You can go into your room, Joe Bonecrusher's Room, the Doves" Room, and the Kitchen. You could also go outside, even though it's really cold.

>room
That's not a verb I recognise.

>my room
That's not a verb I recognise.

>go into my room
You get into Your Room.

>i
You are carrying nothing.

I beg your pardon?

I beg your pardon?

>x me
Your real name's Eliza Sommers, but you're disguised as a boy named Elias Andieta. You've gone by this name while in America to find your lover; Joaquin Andieta. You've travelled with Joe and her Doves for a while as their piano player after meeting them in a town some time ago. Since it's winter now, you've settled down in a Barn to wait it out.

>x your room
You share this room with Babalu the Bad and Tom No-Tribe. The bed is big enough for all three of you to fit, but usually Babalu is awake at night and paces along the barn, so usually it's just you and Tom No-Tribe keeping warm. Along the barn wall is a bag with your belongings and Tom No-Tribe is just sitting on the ground.

>x bed
Which do you mean, large bed, Joe's Bed, blue bed or red bed?

>x Joe's bed
Joe's bed is all made up.

>x blue bed
The blue bed is the sisters" bed. The bed is neat and tidy.

>x red bed
Esther and the Mexican dove share the red bed.

>x large bed
You can't see any such thing.

>x barn
You can't see any such thing.

>talk to Tom
Try asking Tom about something what you need instead.

>ask TOm
What do you want to ask Tom No-Tribe for?

>ask Tom about knife
Tom doesn't seem to want to talk about it and just looks away from you.

There is no reply.

>ask Tom about sharp knife
He scoffs and looks at you like you should know where to find that already.

>go to kitchen
You can't see any such thing.

>leave room
I only understood you as far as wanting to leave.

>leave
You get out of Your Room.

Barn
Joe and Babalu stand by in the barn. Jack sits in a chair by a table and stove. You can go into your room, Joe Bonecrusher's Room, the Doves" Room, and the Kitchen. You could also go outside, even though it's really cold.

>kitchen
That's not a verb I recognise.

>go into kitchen
You get into Kitchen.

On Counter is Big box (closed).

>x big box
The box is made of wood. Joe usually has the key to unlock it.  The big box is used to store a sharp knife.

>x counter
Upon closer inspection you see a small box underneath it.

On Counter is Big box (closed).

>x small box
It's a small wooden box. Joe probably carries the key to it.

>x key
This key unlocks the toolbox and the big box in the kitchen.

>damn it why dont have key
That's not a verb I recognise.

>leave
You get out of Kitchen.

Barn
Joe and Babalu stand by in the barn. Jack sits in a chair by a table and stove. You can go into your room, Joe Bonecrusher's Room, the Doves" Room, and the Kitchen. You could also go outside, even though it's really cold.

>go to barn
You can't see any such thing.

>talk to Joe
(Joe Bonecrusher)
Try asking Joe about what you need instead.

>ask joe
What do you want to ask Joe Bonecrusher for?

>ask joe about hammer
(Joe Bonecrusher about that)
That's inside of the toolbox.

>ask joe about toolbox
(Joe Bonecrusher about that)
You'll need a key to open it.

>ask joe for key
(Joe Bonecrusher for Key)
(Joe Bonecrusher first taking Key)
Joe Bonecrusher has better things to do.

>ask joe about key
(Joe Bonecrusher about that)
Here, I have it.

>thanks
That's not a verb I recognise.

>check inventory
You can't see any such thing.

>i
You are carrying:
  Key

>x key
This key unlocks the toolbox and the big box in the kitchen.

>leave
Barnyard
The strong wind blows you around and you lose your bearings.

>undo
Barn
[Previous turn undone.]

>go to kitchen
You can't see any such thing.

>go into kitchen
You get into Kitchen.

On Counter is Big box (closed).

>unlock big box
(with Key)
You unlock Big box.

>x big box
The box is made of wood. Joe usually has the key to unlock it.  The big box is used to store a sharp knife.

>inspect big box
That's not a verb I recognise.

>x big box
The box is made of wood. Joe usually has the key to unlock it.  The big box is used to store a sharp knife.

>look inside bix box
You can't see any such thing.

>undo
Barn
[Previous turn undone.]

>go into kitchen
But you're already in Kitchen.

>take knife
You can't see any such thing.

>unlock big box
(with Key)
That's unlocked at the moment.

>take knife
You can't see any such thing.

>take sharp knife
You can't see any such thing.

>x big box
The box is made of wood. Joe usually has the key to unlock it.  The big box is used to store a sharp knife.

>x knife
You can't see any such thing.

>knife
That's not a verb I recognise.

>knife
That's not a verb I recognise.

>action on
That's not a verb I recognise.

>actions off
Actions listing off.

>take knife
You can't see any such thing.

>actions on
Actions listing on.

>take knife
You can't see any such thing.

>actions off
Actions listing off.

>gimme gimme gimme
Sure, why not, cheater.

Barn
Joe and Babalu stand by in the barn. Jack sits in a chair by a table and stove. You can go into your room, Joe Bonecrusher's Room, the Doves" Room, and the Kitchen. You could also go outside, even though it's really cold.

Now that you have collected all the materials you need, you can cut off Jack's fingers. You review what you had learned at Tao Chi'en's side when he had extracted bullets and stitched up wounds in Sacramento…The most important thing was to prevent hemorrhaging and infection. Although you have not watched him do any amputations, but when he was treating unlucky patients whose ears had been cut off, he had commented that in other lands they cut off hands and feet for the same crime. "The executioner's ax is quick, but it doesn't leave any tissue to cover the stump of the bone," Tao had told you. You know that all you need to do now is cut off the fingers, clean up the blood, then stitch up the stumps. It would probably be safer if you disinfected the knife first; heating it up would do the trick.

>cut off hand
You can't see any such thing.

>cut off fingers
Try saying cut jack's fingers.

Now that you have collected all the materials you need, you can cut off Jack's fingers. You review what you had learned at Tao Chi'en's side when he had extracted bullets and stitched up wounds in Sacramento…The most important thing was to prevent hemorrhaging and infection. Although you have not watched him do any amputations, but when he was treating unlucky patients whose ears had been cut off, he had commented that in other lands they cut off hands and feet for the same crime. "The executioner's ax is quick, but it doesn't leave any tissue to cover the stump of the bone," Tao had told you. You know that all you need to do now is cut off the fingers, clean up the blood, then stitch up the stumps. It would probably be safer if you disinfected the knife first; heating it up would do the trick.

>cut off thumb
You can't see any such thing.

>cut off the finger
You can't see any such thing.

>cut Jack's fingers
You position the knife on the finger  and hit it smartly with the hammer, driving the blade cleanly through the bones and into the wood of the table.

Now that you have collected all the materials you need, you can cut off Jack's fingers. You review what you had learned at Tao Chi'en's side when he had extracted bullets and stitched up wounds in Sacramento…The most important thing was to prevent hemorrhaging and infection. Although you have not watched him do any amputations, but when he was treating unlucky patients whose ears had been cut off, he had commented that in other lands they cut off hands and feet for the same crime. "The executioner's ax is quick, but it doesn't leave any tissue to cover the stump of the bone," Tao had told you. You know that all you need to do now is cut off the fingers, clean up the blood, then stitch up the stumps. It would probably be safer if you disinfected the knife first; heating it up would do the trick.

>clean up blood
Jack's fingers are tossed aside and you wipe up the blood as best as possible so you can stitch jack's wounds.

Now that you have collected all the materials you need, you can cut off Jack's fingers. You review what you had learned at Tao Chi'en's side when he had extracted bullets and stitched up wounds in Sacramento…The most important thing was to prevent hemorrhaging and infection. Although you have not watched him do any amputations, but when he was treating unlucky patients whose ears had been cut off, he had commented that in other lands they cut off hands and feet for the same crime. "The executioner's ax is quick, but it doesn't leave any tissue to cover the stump of the bone," Tao had told you. You know that all you need to do now is cut off the fingers, clean up the blood, then stitch up the stumps. It would probably be safer if you disinfected the knife first; heating it up would do the trick.

>stitch Jack's wounds
Using the needle and thread, you stitch the wounds close.

Now that you have collected all the materials you need, you can cut off Jack's fingers. You review what you had learned at Tao Chi'en's side when he had extracted bullets and stitched up wounds in Sacramento…The most important thing was to prevent hemorrhaging and infection. Although you have not watched him do any amputations, but when he was treating unlucky patients whose ears had been cut off, he had commented that in other lands they cut off hands and feet for the same crime. "The executioner's ax is quick, but it doesn't leave any tissue to cover the stump of the bone," Tao had told you. You know that all you need to do now is cut off the fingers, clean up the blood, then stitch up the stumps. It would probably be safer if you disinfected the knife first; heating it up would do the trick.

>good job cam
That's not a verb I recognise.

* * *

Jack, the Mexican that showed up a couple days ago needs the fingers on his left had to be cut off due to frostbite. He sits in a chair in the barn. You'll need a sharp knife, a hammer, a needle, thread, and clean rags to cut it off.

Daughter of Fortune
An Interactive Fiction by Izzy
Release 1 / Serial number 141007 / Inform 7 build 6L02 (I6/v6.33 lib 6/12N) SD

Barn
Joe and Babalu stand by in the barn. Jack sits in a chair by a table and stove. You can go into your room, Joe Bonecrusher's Room, the Doves" Room, and the Kitchen. You could also go outside, even though it's really cold.

>go into my room
You get into Your Room.

>go into my room
But you're already in Your Room.

>talk to tom
Try asking Tom about something what you need instead.

>x my bag
You store all your stuff in here.

In your bag are Binding cloth, Music Sheets and Jacket.

>leave
You get out of Your Room.

Barn
Joe and Babalu stand by in the barn. Jack sits in a chair by a table and stove. You can go into your room, Joe Bonecrusher's Room, the Doves" Room, and the Kitchen. You could also go outside, but it's freezing and probably not a good idea.

* * *

Jack, the Mexican that showed up a couple days ago needs the fingers on his left had to be cut off due to frostbite. He sits in a chair in the barn. You'll need a sharp knife, a hammer, a needle, thread, and clean rags to cut it off.

Daughter of Fortune
An Interactive Fiction by Izzy
Release 1 / Serial number 141007 / Inform 7 build 6L02 (I6/v6.33 lib 6/12N) SD

Barn
Joe and Babalu stand by in the barn. Jack sits in a chair by a table and stove. You can go into your room, Joe Bonecrusher's Room, the Doves" Room, and the Kitchen. You could also go outside, even though it's really cold.

>cut jack's hand
You can't see any such thing.

>cut
What do you want to cut?

>cut jack
Cutting him up would achieve little.